1111111111111111
1111111111111111
111111....111111
111..........111
000..........000
................
.......00.......
.......00.......
................
................
................
................
................
................
................
................